#####################
#J..P.#...#@#...#...#
#.###...###.#.#@#.#.#
#..@#.#.#...#.#...#.#
#@#...#...#...#.#.#@#
#####################